

R   1920   1080

F   0,255,127
C  255,105,180


WE  ./textures/girl.xpm 
EA ./textures/demon.xpm    
S  ./textures/sprite_1.xpm   

SO ./textures/israel.xpm

NO     ./textures/bird.xpm



        1111111111111111111111111
        1000000000110000002000001
        1011000001110000002000001
        1001000000000000000200001
1111111110110000011100N0000000001
100000000011000001110111111111111
11110111111111011100000010001
11110111111111011101010010001
11000000110101011100000010001
10000000000000001100200010001
10000000000000001101010010001
1100000111010101111101111000111
11110111 1110101 101111010001
11111111 1111111 111111111111

